###############################################################################################################################################################################################################
###   ###   ###               ###               ###                     ###                     ###                                       ###                           ###               ###               ###
###   ###   ###   ###   #########   ###   ###   ###############   #########   ###############   ###   ###   ###########################   ###   ###   #####################   #########   ###   ###   #########
###   ###         ###   ###         ###   ###   ###               ###         ###         ###         ###               ###                     ###   ###                           ###         ###         ###
###   #########   ###   ###   #########   ###   ###   #########   ###   ###############   ###########################   #################################   #############################################   ###
###         ###   ###         ###         ###         ###         ###   ###               ###                     ###                                 ###         ###               ###                     ###
#########   ###   ###############   ###   ###########################   ###   #########   ###   #########   ###   #################################   #########   ###   #########   ###   ###############   ###
###         ###   ###         ###   ###   ###         ###         ###         ###         ###         ###   ###               ###         ###         ###         ###   ###   ###         ###   ###         ###
###   ###############   ###   ###   ###   ###   ###   ###   ###   ###############   #########   #########   ###############   #########   ###   ###   ###   #########   ###   ###############   ###   #########
###                     ###   ###   ###   ###   ###         ###                     ###         ###         ###         ###               ###   ###   ###         ###   ###         ###               ###   ###
###########################   ###   #########   ###################################################   #########   #####################   ###   ###############   ###   ###   ###   ###   ###############   ###
###   ###               ###   ###               ###                     ###                     ###   ###                     ###         ###   ###               ###   ###   ###   ###                     ###
###   ###   #########   ###   ###   ###############   ###   #########   ###   #########   ###   ###   #####################   ###   #########   ###   ###############   #########   #####################   ###
###         ###   ###         ###         ###         ###   ###   ###   ###   ###         ###         ###                     ###   ###   ###   ###   ###         ###   ###               ###         ###   ###
###   #########   #####################   ###############   ###   ###   #########   #####################   ###############   ###   ###   ###   ###   ###   #########   ###   #########   ###   #########   ###
###         ###   ###                     ###               ###   ###   ###         ###                           ###         ###         ###   ###         ###         ###   ###               ###         ###
#########   ###   ###   #####################   ###############   ###   ###   #####################   #########   ###   ###############   ###   #########   ###   #########   #####################   #########
###   ###   ###                           ###         ###               ###         ###         ###         ###   ###   ###               ###               ###   ###   ###         ###         ###   ###   ###
###   ###   ###########################   ###   ###   ###############   #########   ###   ###   ###############   #########   #################################   ###   ###   ###   ###   ###   ###   ###   ###
###   ###               ###               ###   ###               ###         ###   ###   ###               ###   ###         ###               ###               ###         ###         ###   ###         ###
###   ###############   ###   #################################   #########   ###   ###   ###############   ###   ###   #########   #########   ###   #####################   ###############   #########   ###
###         ###         ###                     ###               ###               ###               ###   ###         ###               ###   ###                     ###         ###   ###               ###
###   ###   ###   ###########################   ###   ###############   ###########################   ###   #########   ###############   ###########################   #########   ###   #####################
###   ###         ###         ###               ###   ###               ###               ###         ###         ###               ###   ###                           ###   ###                     ###   ###
###   ###############   ###   ###   ###############   #########   #########   #########   ###   ###############   ###############   ###   ###   ###########################   #####################   ###   ###
###         ###         ###   ###   ###                     ###         ###   ###   ###         ###   ###         ###         ###         ###   ###               ###                     ###         ###   ###
#########   ###   #########   ###   #####################   ###   #########   ###   ###############   ###   #########   ###############   ###   ###   ###   ###   ###   ###############   ###   #########   ###
###   ###   ###   ###         ###         ###               ###   ###         ###                     ###   ###               ###         ###   ###   ###   ###   ###   ###         ###         ###         ###
###   ###   ###   #####################   ###   #####################   ###########################   ###   ###   #########   ###   #########   #########   #########   ###   ###   ###############   ###   ###
###   ###   ###   ###               ###   ###         ###               ###                           ###   ###   ###   ###   ###   ###   ###         ###   ###         ###   ###   ###         ###   ###   ###
###   ###   ###   ###   ###   #########   #########   ###   ###############   ###########################   ###   ###   ###   ###   ###   #########   ###   ###   #########   #########   ###   ###   ###   ###
###         ###   ###   ###               ###         ###         ###         ###                     ###   ###   ###   ###   ###               ###   ###         ###                     ###         ###   ###
###   #########   ###   #####################   ###   #########   ###   ###   ###   ###############   ###   ###   ###   ###   ###############   ###   #########   ###   #################################   ###
###         ###   ###   ###         ###         ###         ###   ###   ###   ###         ###   ###         ###         ###                     ###         ###   ###                     ###               ###
#########   ###   ###   ###   ###   #########   #########   ###   ###   ###############   ###   #####################   #################################   ###   ###########################   ###############
###   ###   ###               ###               ###         ###   ###   ###               ###         ###               ###         ###               ###   ###                                 ###         ###
###   ###   #######################################   #########   ###   ###   ###############   ###   #########   #########   ###   ###   ###   #########   #####################   ###############   ###   ###
###   ###   ###         ###                     ###   ###         ###         ###               ###         ###   ###         ###   ###   ###   ###         ###               ###   ###               ###   ###
###   ###   ###   ###   ###   ###############   #########   #########   ###############   ###############   ###   #########   ###   ###   #########   ###   ###   #########   #########   ###############   ###
###         ###   ###         ###         ###   ###         ###         ###         ###         ###         ###   ###         ###         ###         ###   ###   ###   ###               ###               ###
###   #########   ###############   ###   ###   ###   ###############   ###   ###   #########   ###   #########   ###   ###############   ###   ###############   ###   #####################   #########   ###
###         ###         ###         ###   ###   ###   ###         ###         ###               ###         ###         ###         ###   ###   ###               ###               ###         ###         ###
#########   #########   #########   #########   ###   ###   ###   #######################################   #####################   ###   ###   ###   ###############   ###   ###   ###   ###############   ###
###   ###         ###         ###   ###         ###   ###   ###               ###         ###               ###               ###   ###   ###         ###   ###         ###   ###   ###               ###   ###
###   #########   #########   ###   ###   #########   ###   ###############   ###   ###   ###   ###############   #########   ###   ###   ###############   ###   #########   #####################   ###   ###
###         ###               ###   ###   ###                           ###   ###   ###         ###                     ###         ###   ###                     ###         ###               ###   ###   ###
###   ###########################   ###   #################################   ###   #################################   ###############   ###   #####################   ###   ###   #########   ###   ###   ###
###   ###                     ###         ###         ###               ###   ###   ###                           ###                     ###         ###               ###   ###         ###         ###   ###
###   ###   ###############   ###   #########   ###   ###   #########   ###   ###   ###   ###   ###############   #########   ###########################   ###############   #########   #####################
###   ###               ###         ###         ###         ###   ###         ###   ###   ###               ###         ###                                 ###                     ###                     ###
###   ###############   ###############   #####################   ###############   ###   ###############   #########   #########   ###################################################   ###############   ###
###               ###               ###                     ###               ###   ###               ###   ###   ###         ###   ###               ###                           ###   ###         ###   ###
#########   #####################   ###   ###############   ###   ###############   ###   ###############   ###   #########   #########   #########   ###   #####################   ###   #########   ###   ###
###         ###               ###   ###   ###         ###   ###                     ###   ###               ###   ###         ###         ###   ###         ###         ###         ###               ###   ###
###   #########   #########   ###   ###   #########   ###   #####################   #########   ###############   ###   #########   #########   ###############   #########   #####################   ###   ###
###                     ###   ###   ###               ###                     ###               ###               ###               ###                                       ###               ###   ###   ###
###   #####################   ###   ###############   #####################   ###########################   ###   #####################   #############################################   #########   ###   ###
###   ###                     ###   ###                     ###         ###         ###                     ###   ###               ###   ###         ###                                 ###         ###   ###
#########   ###############   ###   ###############   #########   ###   #########   ###   #####################   ###   ###   #########   ###   ###   ###   ###   #####################   ###   #########   ###
###         ###               ###               ###   ###         ###         ###   ###         ###                     ###   ###         ###   ###         ###   ###         ###   ###   ###   ###         ###
###   #########   ###########################   #########   ###############   ###   #########   ###########################   ###   ###########################   ###   ###   ###   ###   ###   ###   #########
###   ###               ###               ###         ###         ###         ###         ###   ###               ###         ###                           ###         ###   ###         ###   ###         ###
###   ###############   ###   #########   #########   #########   ###   #########   ###   ###   ###   #########   ###   #################################   ###############   ###############   #########   ###
###         ###         ###         ###               ###         ###   ###   ###   ###   ###               ###   ###         ###                     ###   ###         ###   ###                     ###   ###
#########   ###   ###############   #####################   #########   ###   ###   ###   #####################   ###############   #########   #########   ###   ###   ###   ###   #####################   ###
###         ###               ###   ###         ###         ###   ###   ###         ###         ###               ###         ###   ###         ###         ###   ###   ###               ###               ###
###   ###########################   ###   ###   #########   ###   ###   #####################   ###   ###############   ###   ###   ###   #########   #########   ###   #####################   #########   ###
###                                       ###               ###                                 ###                     ###         ###                           ###                           ###         ###
###############################################################################################################################################################################################################
