###################################################################################################
###   ###                                             ###               ###               ###   ###
###   #####################   #####################   ###   #########   ###   ###   ###   ###   ###
###                     ###         ###         ###         ###   ###   ###   ###   ###   ###   ###
#####################   #########   #########   ###############   ###   #########   ###   ###   ###
###               ###               ###         ###               ###               ###   ###   ###
#########   ###   #####################   ###   #########   ###   #####################   ###   ###
###         ###                           ###         ###   ###   ###               ###   ###   ###
###   ###############   ###########################   ###   ###   ###############   ###   ###   ###
###   ###         ###   ###                     ###         ###                     ###   ###   ###
###   ###   ###   #########   ###############   ###############   #####################   ###   ###
###         ###   ###         ###         ###   ###         ###   ###               ###         ###
###   #########   ###   #########   #########   ###   ###   ###   ###   #########   #########   ###
###   ###         ###         ###   ###         ###   ###         ###   ###               ###   ###
###   ###   ###############   ###   ###   #########   ###############   ###   ###############   ###
###   ###               ###         ###   ###         ###         ###   ###   ###         ###   ###
###   ###############   ###   #########   ###   #########   ###   ###   ###   ###   ###   ###   ###
###   ###         ###   ###   ###         ###               ###   ###   ###         ###   ###   ###
###   ###   #########   ###   ###   ###########################   ###   ###############   ###   ###
###   ###   ###         ###   ###         ###         ###         ###               ###   ###   ###
###   ###   ###   #########   #########   ###   ###   #########   ###############   ###   ###   ###
###   ###   ###                     ###         ###         ###         ###         ###         ###
###   ###   ###########################   ###############   ###############   #####################
###   ###   ###                     ###               ###         ###         ###               ###
###   ###   ###   ###############   ###############   #########   ###   #########   ###   #########
###         ###         ###   ###               ###   ###         ###   ###         ###         ###
#####################   ###   ###############   #########   ###   ###   ###   ###############   ###
###                     ###   ###         ###         ###   ###   ###   ###               ###   ###
###   #####################   ###   ###   #########   ###   #########   #########   #########   ###
###   ###               ###         ###                     ###         ###         ###         ###
###   ###   #########   #######################################   #####################   ###   ###
###               ###                                                                     ###   ###
###################################################################################################
